#####################
I       #         # #
####### # ##### # # #
#       # #     #   #
# ####### # #########
#         # #       #
# ####### # # ##### #
#     #   # # #     #
##### ##### # # #####
# #   #   #   #   # #
# # ### # ##### # # #
# # # # #     # #   #
# # # # ##### # ### #
#   #   #   # # #   #
# ##### # # # # #####
# #     # #   #     #
### ### # ######### #
#   # # # #         #
# ### # ### ####### #
#     #     #       F
#####################
