#########################################
I   #       #     #     #       # #     #
# # ####### # ### # ### # ##### # # # # #
# #         # #     #   #     # #   # # #
# ### ### ##### ############# # ##### ###
#   # #   #   # #       #     # #   #   #
### ### ### # # # ##### ##### # # # ### #
# #   #   # #   # #   # #     #   #   # #
# ### ### # ##### # ### # ##### ##### # #
#     #   #   # #   #   #   # # #     # #
######### ### # ##### ##### # # # ##### #
#         # #   # #   #   # #   #     # #
# ##### ### ### # # ### # # ########### #
#   #   #         # #   # # #     #   # #
### # ### ######### # ##### # # ### # # #
#   # #         # #         # #     #   #
##### # ####### # ######### # ######### #
#   #     #   # #           #         # #
# # ##### # # # # ### ### ############# #
# # #   # # # #     # #   #     #       #
# # ### # # # ####### # ##### ### #######
# #     #   # #       #     #   #   #   #
# ############# ########### ### ### # # #
#             #   #       #   #     # # #
############# # # ####### ### # ##### ###
#   #           # #   #   #   #   #     #
# ### ####### ### # # # ### ##### ##### #
# #   #       #   # # # #       # #   # #
# # ### ##### # ##### # # # ##### # # # #
#   #   #   # # #   # # # # #   # # #   #
########### # # # # # # # ### # # # #####
#     #       #   #   # #     #   # #   #
# ### # ##### ######### ### ####### # # #
#   # #     #       #   # # #     #   # #
# # ####### ####### # ### # # ### # ### #
# #       #       #   # # # #   # #   # #
# ####### # ##### ##### # # ### # # # ###
#       #   #   #     #   #   # # # #   #
####### ##### # ##### ### # # # # # ### #
#       #     #       #     #   #   #   F
#########################################
