#####################################################################################################
F     #   # #     #   #   # #   #   #   #   # #   #       #       #       #       #   # #         # #
### # ### # # ### # # # # # # ### # # # # # # # # # ##### # ##### ### ### # ##### # # # # ### ### # #
# # #       # # #   # # # #       #   #   #   # # # #   # #     #     #   # #   # # # #   #     # # #
# # # # ##### # ##### # # ##### ### ####### ### # # # ### ##### ######### # ### # # # ######### # # #
#   # #     # #   #     # #   # #   #   #     # # #   #   #   #   #       #   #   # # #   #     # # #
##### ##### # # # # # ### # # ### ### # ##### # # ##### ### # ### ### ####### ##### # ### # ##### # #
# #   #     #   # # #   # # #     #   #       # #   #     # #       #   #   # #     #       #   # # #
# # ### # ######### ### # # ####### ########### ### ### # # ##### # ### ### # ############### # # # #
# #   # # #         #   #   # #     #         #   #   # # #   #   #   #     #   #   #         # #   #
# ### # ### ##### ### ####### # ##### ####### ### ### # # ##### ##### ######### # ### # ########### #
#     #   # #     # # #   # #   #     #     # #   #   # # # #   #   #           #     #     #       #
# ### ### # # ##### # # # # ##### ##### ### # # ### ##### # # ### ##### ################# # # # #####
#   #   #   #       # # #   #   # #   # # #   #   # #     # #         # #         #   #   # # # #   #
# ################# # # ### # # # # # # # ######### # ##### ######### ### ####### # # ##### ### ### #
#         # #       #   #   # #   # # # # # #   #   #   # #         #   #       #   #     #   #   # #
######### # # ########### ### ##### ### # # # # # ##### # # ########### ####### ### ##### # # ### # #
#         #   #     # #   #   #   #       #   #   #     # #     #   #             # #   # # #   # # #
######### ##### ### # # ### ### ####### # # ### ### ##### ### # # # ### ### ####### # # # ##### # # #
#         #     # # # #   # #   #   #   #     #   #   #   # # # # #   # #   # #     # # #       #   #
# ########### # # # # ### # # # # # # ##### # ### ### # # # # ### ### ### ### # ####### ######### ###
#       #   # # #   # # # # # #   #   # #   #   #     # # # #   # # #     #     #       #   #     # #
####### # # ### ### # # # # # ######### # ### # ### ### # # ### # # ######### ### ##### # # # ##### #
#   #   # #   #   # # # # # #   #   # # # #   #   # #   # # #   #   #       # #   #   #   #         #
# # # ### ### # ### # # # # ### # # # # # # ##### # # ### # # ####### ##### # # ### # ######### #####
# # #     # #   #   # #     #   # # # #   # #   # # # #   # # #     # #   # # #   # #     #     #   #
### # ##### ##### ### # ##### ##### # ####### # # # ### ### # # ##### # # # # ### # ####### ##### # #
#     #     #   #   # #     #       #       # #   #   #       #     #   # # # #   #         #   # # #
# # ### # ### # ### # ##### ######### ##### ### ##### ##### ####### ####### # # # ### ##### # # # # #
# # #   # #   #   # #   #   #     #       #   # #   #     #     #   #     #   # # # #   #   # #   # #
# ### ### # ### # # ### # ### ### # ##### # # ### # ##### ##### # # # ### # ##### # ### ##### ##### #
#   #   # # #   # # # # # # #   # # # #   # #   # #           # # #   # # # #   #   # # #     #   # #
### ##### ### ##### # # # # # ### # # # ### ### ####### ##### # # ##### # # # # # ### # # ##### # # #
#   #     #     #   # #   #     # # #   #     #         #     #     #   # # # # # #   #   #     #   #
# ### ##### ##### ### ####### # ### ####### # ##### ##### ####### # # ### # # # # # # ##### ##### ###
#   #   #       # #       #   #     #       # #   #     # #   # # # # #   #   # # # # #     #       #
### ### ####### # # # ### ########### ####### # ##### # # # # # # ### # ### ### # # # ####### # ### #
#   # # #       #   #   #   #       # #     # # #     # #   #     #   #     #   #   #     # # #   # #
# ### # # ##### # ##### ### # ##### ### # # # # # ##### ### ####### ### ### # ### ####### # # ### # #
#       #     #   #     #   #     #     # #   #   #       #         #   #   #     #       #   #   # I
#####################################################################################################
