#############################################################
I #   #       #             #       #           #     #   # #
# # # # # ### # ########### # ##### # ######### # # # # # # #
# # #   # #     #   # #     #   #     #   #     # # # # #   #
# # # ##### # ### # # # ##### # ######### # ##### ### # ### #
#   # # #   # #   # # #     # #     #     # #     #   #   # #
##### # # ### ##### # ##### ####### ### ### # ##### ##### # #
#   # # # #   #     #     #       #   #     #   # # #   # # #
# ### # # # ### # ####### ### # # ### ######### # # # # # # #
#     # # #     #     #   #   # # #   # #       #   # #   # #
####### # ### ####### # ### ##### ### # # ### ####### ##### #
#       #   # #   #   # #   #   #     # # #   #   #   #   # #
# ######### # # # # ### # ### # ####### # ### # # # ### # # #
#           #   # #   #   #   #     #     #   # #   # # #   #
################# ### ####### ##### # # ### # # ##### # #####
#   # #     #     # # #       #     # # # # # #     #   #   #
# # # # ### # ##### # # ####### ##### # # # ####### ### # # #
# #   #   #   #   #   # #     #     # # #     #       #   # #
# ##### # ##### # ##### # ######### ### ##### # ########### #
# # #   # #     # #     #       # #   # #   # #   # #     # #
# # # ### # ##### ### ### ##### # ### # # # # ### # # ##### #
# # #   #   #   #   # # # #     # #   #   # #   #   #       #
# # ######### # ### # # # ### ### # ####### ### ### ####### #
# #           #     # # # #   #   #   #     # #   # # #     #
# ### ############### # # # ### ### # ##### # # ### # # #####
# #       #     # #   #   #       # #       #       #   #   #
# # # # ### ### # # ########### # # ############### ##### ###
#   # # #   # # # # # #   #     # # #   #     #   # #   #   #
##### ### ### # # # # # # ### ### # # ### ### ### # ### # # #
#   #   # # #     # # # #     # #   #     # #   # # #   # # #
# # # # # # ### # # # # ####### ########### ### # # # ##### #
# # # #   #     #   #   #   #   #     #       # # #   #   # #
# # ############# ######### # # ##### # ### # # # ##### # # #
# #               #       #   #   #   # #   # # #     # #   #
# ################# ##### ### ### ### ### ##### # ### # #####
# #   #     #   #   #     #   # #   #   #       #   # #   # #
# # # # ### # # # ### ##### ### ### # # ### ####### ##### # #
#   #   # # # #   # #   #         #   #   #             # # #
######### # # ##### ### ################# ######### # ### # #
# #     # #     #   # # #           # #   #     #   #   # # #
# # ### # ### # # # # # # ######### # # ### ### # ### # # # #
#   # #       #   #   # # # #     # # #     #   #   # #   # #
##### ######### # ##### # # # ### # # # ##### ####### ##### #
#     # #   #   # #     #   #   # # # #   # # #   #   #   # #
# # ### # # ####### ####### ### ### # ### # # # # # ### # # #
# # #     #       #   #       #   # # #     #   # # #   #   #
# # ### # ####### ### # ######### # # ##### ##### # ##### # #
# #     # #   # #     #         #   # #   #     # # #     # #
# ####### # # # ### ########### ##### # # ### # # # # #######
#   #     # # # #   #     #   # #   #   #   # # #   #   #   #
### # ##### # # ##### ### # ### # ##### ### # # ####### # # #
# # #   #   # # #   # #   #         #   #   # #         # # #
# # ##### # # # # # # ######### ### # ### # # ##### ##### # #
# #   #   # #   # #     #       #   #   # # #   # # #   # # #
# ### # ### # ### ### # # ####### ##### # ##### # # ### # # #
# #   # #   #   #   # #   #   #   #     #   # # #     #   # #
# # # # # ##### ### # ##### # # ### # ##### # # ##### ### # #
# # #   #     # #   # #     # #     # #   #     #     #   # #
# ########### # # ### # ### ########### # ### ### # ### ### #
#             #   #   #   #             #     #   #     #   F
#############################################################
