#################################################################################
I   #     #         #         #               #       #     #           #     # #
### # ### # ##### # # ####### # ##### ####### # ##### # ### # # ######### ### # #
#   #   # #   #   #   #     #   # #   #   #   #   #   # #   # #           # #   #
# ##### # ### # ### ### ### ##### # ### # # ####### ##### ### ############# ### #
# #   # #     #   #   # #   #   #   #   #   #     # #   #   # #   #   #   # # # #
# # # # ############# # ##### # ##### ####### ### # ### ### # # # # # ### # # # #
#   # #   #   #       #   #   # #     #     # #   # #       # # #   #     # # # #
### # ### # ### ######### # ##### ##### ### ### ### # ####### ### ##### ### # # #
# # #   # #       #       # #       #   #       #   #   #     #   # #   #   # # #
# # ### # ##### ### # ##### # ##### # ### # ####### ### ####### ### # ##### # # #
#   #   # #   # #   # #   # # #   # # #   #           #   #     # #   #   #   # #
### # ### # # # # ### # # # # # # # # # ################# ### # # # ### # ### # #
#   #     # # # #   # # # #   # #   # # #         #     #   # # # # #   #   #   #
# ######### # ##### # ### # ### ##### # # ##### ### ### ### # ### # # ### ##### #
#   #   #   #       #   # # #   #   # # # #       #   #   #       #   # #   #   #
# # # # # ########### # # ### ### # # # # # ##### ### ### ### ######### ### # # #
# #   # # #           #   #     # #   #   # #   #     #   # # #         #   # # #
# ##### # # ############### ##### ######### # # ####### ### # # ######### ### # #
# #   # # # #   #       #       #     #   #   # #   #   #   # #     #     #   # #
# # # # # # # # # ####### ##### # ### # ####### # # # ### ### ### # # ##### ### #
# # # #   #   # #   #   # #     # #   #         # # # #       #   #   #     #   #
# ### ######### ### # # # # ####### ####### ####### # # # ##### ########### # ###
#     #   #     # #   #   #         #     #         #   # # #   #   #       #   #
# ##### ### ##### ######### ######### ### ### ########### # # ### # # ####### # #
#   #       #     #         #       #   # #   #     #     #   #   # # #   # # # #
### # ####### ############### # ### # ### ##### ### # ######### # # # ### # # # #
#   #   #   # #   #           #   # #   #     # #   # #         # # #   # #   # #
# ##### # # # ### # ############# # ### ##### # ##### # ########### ### # ##### #
# #       #         #         #   #     # #   #   #   #       #       # # #   # #
### ####### # ### # # ### ##### ######### # ##### # ####### # # # ##### # # ### #
#   #   #   # #   # #   #       #     # # #     #   #       # # # #     # # #   #
# ##### # ### ######### ### ##### ### # # ##### ##### ####### # # # ##### # # ###
# #     # #   #       # # #     #   #   #       # #         # # # # #     # #   #
# # ####### ### ##### # # ######### # ##### ##### # ######### # ### # ##### ### #
# #   #     # # #   #   #   #     # #   #   #   # #     #   # #     # #   #     #
# # # # ##### # # # ####### ### ### ### # ### # # ####### # # ####### ### #######
# # # #   #   # # # #     #         # # #   # #     #   # #   #       #       # #
# ### ### # ### ### ##### ##### ##### # ### ####### # # # ##### ##### # # ### # #
# #   # # # #       #       #   #     #   #         # # # #     #   #   # # #   #
# # # # # # # ####### ####### ### ####### ##### ##### # # # ####### ##### # #####
# # # #   # #         #   #   #   #     #       #   # #         #   #     # #   #
# # ####### ####### ### ### # # ### ### ########### # ### # ### # ### ##### ### #
#   #     #   #   #   #   # #   #   #   #   # #   #   #   # #   # #   #     #   #
### # ##### # # # ### ### # ##### ### ##### # # # ### # ### # ### # ### ##### # #
# # #     # #   #   #   # #     # # # # #   # # #     # #   #     # #         # #
# # ##### ####### # ### # # ### # # # # # ### # ####### # ######### # ######### #
#   #   #       # #     # # #   # # #   # # #     #   # #   #     #   #         #
### # # ####### # ####### # ##### # ### # # ##### # ### ### # ### ##### #########
#   # #     # # # #     #   #     #         #   # #     #     #   #     #       #
# ### # ### # # # # ### ##### ######### ##### # # ####### ##### ### ##### ##### #
#     #   # # #     #   #   #   # #   # #   # #       #   #     # #       # #   #
######### # # ### ### ### # ### # # # # # # ##### ### # ### ##### ######### # ###
#     #   # # # #   #     #     #   # #   # #   # #   # # #     #   #     #     #
# ### # # # # # ### ######### ####### ### # # # # # ### # ##### # # # ### ##### #
# # #   # # # #     #   #     #     #   # #   #   #   #   #   #   #   #   #     #
# # ####### # ######### # ### ### # ### # # ######### ### # # ######### #########
# # #   #   #           # # #   # #   #   #   #     # #   # #           #       #
# # # # # ### ########### # ### # ############# ##### # ### ######### ### ##### #
# # # #       # #   #   #     #   #   #       #     # # #   #       #     #     #
# # # ######### # # ### ### ####### # ####### ##### # # ##### ### ######### #####
#   #         # # # #   #       #   #     # # #   #   #     #   #   #       #   #
######### ### # # # # ####### ### ### ### # # # # ######### ### ### # ######### #
#         #   # # #   #     #   #   # #   #   # #           #   #   # # #     # #
# ######### ### # ######### ### ### # # ### ### ############# ### ### # # ### # #
# #     #   #   #       #       #   # #   # #   #     #   # # # # #   #   #   # #
# # ### # ### # # ### # # ####### ### ### # # ##### ### # # # # # # # # ### ### #
#   # # # #   # #   # # #     #   #     # # #   #   #   # #   #   # # # #   #   #
##### # # # ### ### ### ##### # ##### ### # ### # ### # # # ### ### # # # ### ###
#   # # #   # # # # #   #   # # #   #   #   #   # #   # # # # #   # # # #       #
# # # # ##### # # # # ### # # ### # ### ##### # # # ##### # # ### # ### ####### #
# #   #     #   #   # #   # #     #   # #   # # # # # #   #     # #     #     # #
# ######### ######### # ### ##### ### # # # # # # # # # ####### ########### # ###
#         #       #   #   #   #   # #   # #   # #   #   #     # #         # #   #
### ##### ##### # ### ##### ### ### ##### ##### # ### ### ### # # ### ### # ### #
#   #   #       #   #     #   # # #       #   #   #   #   # #   #   # # #   #   #
# ### # ########### ##### ### # # # ####### # ##### ### ### # ##### # # ##### ###
#     #   # #       #     #   #   #       # #       #     #     #   #   #   # # #
# ####### # # ####### ##### ############# # ############# ### # # ### ### ### # #
#       #   #               #             #               #   #   #   #         F
#################################################################################
