#########################################
I   # #     #   #   #   #   #     #     #
# # # # ### # # # # # # # # ##### # ### #
# #   #   #   # # #   #   #     #   #   #
# ##### ####### # # ########### # ### ###
# #   # #         # #     #   # #   #   #
# # # # # ##### ### # # ### # # # # ### #
#   #   # # #   #   # #     #   # #   # #
######### # # ##### # ########### ### # #
# #   #   #   #   # # #     #       # # #
# # # # ####### # # # # ### ### ##### # #
#   #   # #     #   #   #     #   #   # #
######### # ################# # # # ### #
#         #     #   #         # # # #   #
# # ########### # # # ######### # # #####
# #   # #       # # #           # #     #
# ### # # ####### ##################### #
# # #   # #       #   #   #   #         #
# # # ### # ### ### # # ### # # # #######
# #   #   #   # #   #     # #   #       #
# ##### ##### ### ####### # ########### #
#   #       #     #     #   #   #     # #
### # # # # ####### ########### ##### # #
#   # # # # #   # #         #       # # #
# ### # # # # # # ######### # # ### # # #
#   # # # #   #   #       #   # # #     #
### ### # ##### ######### ##### # ### # #
#   #   # #   #   #     # #   # #     # #
# ### ### # # ### # ### # # # # #########
#     #   # #   # # #   #   # #         #
####### ### ### # # # ##### ####### ### #
#   #       #   #   #   #   #   #   # # #
# ### # ##### ######### # ### # # ### # #
#     # #   # #         # # # # #   #   #
####### ### # # ######### # # ### #######
#   #   #   # #           # #           #
# ### ### ### ############# ##### ##### #
# #   #   #   #   #     #   #   # #     #
# # ### ### ##### # ### # ### ### # # ###
#   #   #   #   #   # # # # #     # #   #
##### ### ##### ##### # # # ####### ### #
#   # # #     #       # #           # # #
# # # # ### # ### ##### ######### ### # #
# #   #     #   # #     #   #   #   #   #
# ############# # # ##### # # # ### #####
#       #         # #   # # # # # #   # #
####### # ##### ### # # # # ### # ### # #
#   # #   #   # #   # #   #       #     #
# # # ##### # # # ### # ##### # # # # ###
# #       # # # # #   #     # # #   #   #
# ####### ### # # # ####### # # #########
#     # # #   # # #       # # #         #
##### # # # # # # ### ### # ########### #
#   #   # # #   # #   #   #         # # #
# # ### # # # ### # ############### # # #
# #     # # # #   # #   #         # # # #
# ####### # # # # # # # ### ### # # # # #
#       #   #   # #   #     #   # #   # #
########### # ############### ######### #
#   # #     # #   #   #     # # #       #
# # # # ####### # # ### ### # # # #######
# #   #   #     #   #     #     # #   # #
# ### ### # ######### ### ####### # # # #
# #     #     #     # # #   # #   # #   #
# # ####### # # ### # # ### # # # # #####
# #         # # #   # #   # # # #   #   #
# ######### ### # # # ### # # # ##### # #
#     #   # #   # # # # # # # #   #   # #
# ### # # ### ### # # # # # # ### # ### #
#   # # # #   # # # # # #   #   #   #   #
##### # # # ### # ### # # ##### ##### # #
#   # # #   #   #     # # #     # #   # #
# # # # ##### ####### # # # ##### # ### #
# #   #       #   # #   # #           # #
# ########### ### # ##### ############# #
#   #       # #   # #     #             #
### # ##### # # ### # ####### ###########
# #   #   # #   #   # #     #   #       #
# ##### # # ##### ### # ### ### # ##### #
#       #   #   # #   # #   #   #     # #
####### ##### # # # # # # ### ##### # ###
#   #   #     #   # # # #   # #   # #   #
# # # ### ######### ### ### # ### # ### #
# # #   #   #     #       # #   #     # #
# # ### # # # ### # ####### ### ### ### #
# # #   # # # # #   # #   #   #   #   # #
# ### ### # # # ##### # # ### ### ### # #
#   #   # # # # #       #   #   #     # #
### ### ### # # ########### ### ####### #
# # #     # #   #         #     #   #   #
# # ### # # ##### ####### ####### ### ###
#       #   #   #     #         #       #
### ########### ##### # # ##### ##### ###
#   #   #   #   #   # # # #   #     #   #
# ### # # # # ### # ### # # # ### ##### #
#   # # # # #     #     #   #   #       #
### # # # # # ################# #########
# # # # # #   #     #   #   #   #     # #
# # # ### ##### ##### # # # # ### # # # #
#   #     #           #   #       # #   F
#########################################
