#####################################################################################################
I         #       #     #   #       #   #         #     #   #       #   #           #   #   #   #   #
######### # ##### # ### # # ####### # # ### ##### ##### ### # ##### # ### ######### ### # # ### # # #
# #       # #     #   # # #       # # #   # #     #   # #     #   # # #   # #     # #   # # #   # # #
# # ####### # ####### # ######### # # ### # # ##### # # # ##### # # # # ### # ##### # # # # # # ### #
# #     # # #   #   # #     #   # #     #   # #   # #   #     # #   #   # # #       # # # #   #   # #
# ##### # # ### # ### ##### # # # ##### ##### # # # ######### ######### # # ######### # # ####### # #
# #       # #   # #   #   # # # # #     #       #   #       # #     #   #   #   #     # #   #   # # #
# # # # ### # ### # ### # # # ### # ######### ############# # # ### # ### ### # # # ####### # # # # #
#   # #   # # # # #     # # #       #   #     #     #     # # #   # # #     # # # #       # # #   # #
######### # # # # ### ##### ##### ### # # ##### # ### ### # # ### ### # ##### # # ####### # # ##### #
# #       # #   #     #   #   #   #   #   #     # #     #   #   #   # #       # # #   # # # #       #
# # ####### ### ####### # ### # ### ####### ##### # ####### ### ### # ### ##### ### # # # # #########
#   #   #     # #   #   # # #   #   #       #     # #       #   #   #   # #   #     # # # #   #     #
# ### # ##### # # # # ### # # ####### ####### ##### # ####### ### ##### # # # ####### # # ### # #####
# #   # #   # # # # #   # # # #     #       # #     # #       # #     # #   #   #   #     #   # #   #
# # ### # # # # # # ### # # # # ### ####### # # ##### # ####### # ### # ####### # # ### ### ### # # #
#   #   # # # #   # #   #   # # #     #     # # #     # #     #   #   #   #       #   # #     #   # #
##### ### # # ##### # ### ### ### ### ####### # # ##### # ### ##### ##### ########### # # # # ### # #
#     #   #   #     # #     #     #     #     # # #   # #   # #   # #   #   #     #   # # # #   # # #
# ##### ####### ##### ##### ####### ### # ##### # # # # ### # # # # # # ### # ### # ### # ##### # # #
# #   # #     # #     #     #     #   #         # # # #     # # #   # #   # # #   # #   #   #     # #
# # ### ##### # # # ### ##### ### ### ### ####### # # ####### # ##### ### # # # ##### # ### ####### #
#     #     #   # # #       # #   #   # #   #     # # #   # # #     # #   # # # #     # #   #       #
##### ### ####### # ##### ### # ### ### ### ##### # # ### # # ##### # # ### # # # ##### # ### #######
#     #   #     # # #   #     #     # #   #   # # # #       #       # #     # #   #   # # #   #     #
# ####### # # # # # # ####### ####### ### # # # # ##### ##### # ##### ### ### ##### # # # # ### ### #
#       #   # #   # # #   # # # #   #   #   # # #       #   # # #   # #       #     # # # #     #   #
####### ##### ##### # # # # # # # # ### ##### # ### ##### # # # # # # # ####### # ### # # ####### ###
#       #     #     #   # #   #   # #   #     # #     #   # # #   #   #     #   # #   #     #     # #
# # # ### ##### ######### ######### # ######### ##### # ### # ############### ### # ####### # ### # #
# # #   #   #           # #   # #   #       #   #   #   # # # #   #       #   # # #     #   #   # # #
### ####### # ######### # ### # # ######### # ### # # ### # # # # # ##### # ### # ####### ##### # # #
#         # #   #       # #   # # # #   # #   #   # # #   #   # #   #   # #   # #         #   # #   #
# ##### # # ### # ### ### # ### # # # # # ### # ### # # ####### ##### ### # # # ##### ##### # #######
#     # # # # # #   #     #   # #     # # # # # # # # #       # #   #     # #     #   #     #   #   #
##### ### # # # # # ######### # # ##### # # # # # # # ####### # ### ############# # ########### # # #
#   #   # # #   # #   #     # # #   # # #     # #   # #       #   # #             #       #     # # #
# # ### # # ####### ### ### # # ### # # # ### # ##### # ######### # ### ############### # # ##### ###
# #     #   #       #   #   # #   # #   #   # #     #   # #     # #     #       #   #   #   #   #   #
# ########### ####### ### ### # # # ##### ### ##### ##### # ### # # ##### ### # # # ######### # ### #
# #   #     # #     # # #   # # # #   #   #   # #   #     # #   # # #     # # # # #   #     # #   # #
# # # # ##### # ### # # ### # # # ### # ### ### # ### ### # # ### # ### ### # # # ### # ### # ### # #
# # # #     # # #   # # #       #     # # # # # # #   #   # # #   #   # #   # #   #     #   # #   # #
# ### ##### # # ##### # # ############# # # # # # # ### ### # # ##### # ### # ##### ######### # ### #
#     #       #     #   #             #   #   #   #   #   # # # #     # #   # #   #   #   # # #   # #
####### ### # ##### ### ############# ### ### # ##### ### # # # # ##### # # # ### ### # # # # ### # #
#   #   #   # #     #   #           #   #   # #     # # #   # # #   #   # #     #     # # # #   #   #
# # ##### ##### ##### ### # # ##### ### ### # ### # # # ##### # ### ########### ####### # # ### ### #
# #       #           #   # #   # #     #   # #   #   #       #   #   #       #       # #   # # # # #
# ##### ### ########### ####### # ####### ### # ####### ####### # ### # ##### # ##### # ### # # # # #
#     # #   #       #   #       # #     # # # # #     #   #   # # # # # #   #   #     #   # #   #   #
# ### # # ### ##### # ### ####### ### # # # # # # ####### ### # # # # # # # ##### # ####### # #######
# #   # # # #   # #   #   #     # #   # #   # # #         #   # #   # # # # #     #     #   #     # #
# # ### # # ### # ##### ### ### # # ### ##### # ########### # # # ### # # ### ######### # ####### # #
# #   # # #     # #     #   # #     #   #   # # #         # #   # #   # #   #     #   #   #   # # # #
##### # # # ##### # ##### ### ####### ### # # # # ####### # ####### ### ### ##### # # ####### # # # #
#     #   #   #   # #   #   #   #         #   # #   #     # #     #       #   #   # # # #   #   # # #
# ########### # ### # # ### # # # ### ######### ### # ##### ##### ### ### ### # ##### # # # ### # # #
#     #   # # # #   # #   #   # # # #             # # #   #     # #   #   #   #         # # #   # # #
### # # # # # # ##### ### ##### # # # ########### # # # # ### # # # ####### ##### ####### # # ### # #
#   # # # # # # #   # # # #   # # # #     #       # # # #     # # # #     # #     #       #   #   # #
# ##### # # # # # # # # # ### # # # ### # # ####### # # ######### # # ### # ####### ####### ### # # #
#   #   # # # #   # #   #   #   # #     # #       # # #       #   #   #   #       # #   #   # # #   #
# # # ### # # ##### ### ### ##### # ########### # # # ####### # ####### ######### # # ### ### # #####
# # # #   #   #   # # # # #     # # #       #   #   # #   #   #   #   # #   #   # #     # #   #     #
# ### # ####### # # # # # ##### # # # ##### ########### # # ##### # ### # # # # # ##### # # ##### # #
#     # #   #   #   #   #         # #   # #   #         # #     # #   # # # # #   #     #     #   # #
####### ### # ### ############# ####### # ### ########### # ### # # # # # # ### ### ######### ##### #
#   #   #       # #     #   # #     # #     #   #     #   #   #   # # # # #   #   #   #     # #   # #
# ### ### ##### # # # # ### # ##### # ######### ##### ### ##### ##### # ##### ### # # # ### # # # # #
#         # #   # # # #   #   #     # #       # #     #   #   #   #   #   #   # # # # #   #   # # # #
########### # ### ### ### # ### ##### # # ### # # ### # ### # # ### # ### # ### # ### ### ##### # # #
#         #   #       #   # # # # #     # # #   # #   # #   # #   # #   # #   # #   # #         #   #
# # ##### ########### # ### # # # # ##### # ##### # # # # ### ### ##### # ### # ### # # # ###########
# #   # #             #     #   # #     # #     # # #   #   #   #   # #   #   # #     # #     #   # #
##### # ####################### # ##### # # ### ### ######### # ### # ##### # # ### ### ##### # # # #
#   # #         #     #     #   # #   # #     #   #   #       #   # #   #   #   #   #   #       #   #
# # # ####### # # ### # ### # ### # # ##### # ### ### # ######### # # # # ####### ########### #######
# # #     #   #   # # # #   # #   # #       #   #       #   #     # # #       # #     #     #     # #
# # ##### # ####### # # # ### # ### ########### ##### ### # ####### # ### ### # ##### # ### ##### # #
# #   #   #     #     # #     #       #       #   #   #   #       # #   #   # # #     #   #   #   # #
# ### # ### ### ####### ########### # # # ####### ##### ######### # ### ### # # # ##### ##### ##### #
#   #   # # #       # # # #     #   # # #             #     #     #   # # # #   #   #   #   #       #
### ##### # # # ### # # # # ### ### # ############### # ### # ####### # # # # ##### ##### # ### ### #
#   #   #   # #   #   # #   # #   # # #       # #     #   # #         # #   # #     #   # #   #   # #
# ### # ##### ### ### # ##### ### ### # ##### # # ######### ### ##### # # ### # ##### # # ### ### ###
#   # # #     #     #   #   #   #     #     # # # #   #   #   # #   # # # #     #     # # #   # #   #
### # # # ##### ### ### # # # # # ########### # # # ### # ### # # # # # # ##### ####### # # ### ### #
#   # #     #   #     #   #   # #   #   #     #   #     #   # #   # #   #     # #       # #     # # #
# ### ####### ### ############# ### # # ### ############### # ##### ######### # # ####### ####### # #
# #     #       #   #   #     # #   # # #   #         #     # # #   #       # #   #     # #         #
# ### # ##### # ### # # # ### # # ##### # ##### ##### # ##### # # # # ##### # ##### ### # # #########
#   # # #   # # #   # #   #   #   #   # #           #   #   # #   # # #   # # #     #   #         # #
### ### # # ### # ### ##### ### ##### # # ### ########### # # ##### # ### # # ######### # # ##### # #
#   #     #   # #   # #   #   #       # #   #             # # #   # #     #   #   #     # #     # # #
# ### # ##### # ### # # ##### ######### ### ##### ######### # # # # ####### ### # # ########### # # #
#     # #   # # # # # #       #   #       # #     #     # #   # #   #     #     #   #           # # #
######### # ### # # # ### ##### # # ### # # # ##### ### # ##### ##### ### ####### # # ######### # # #
#         #       #   #         #   #   #   #         #   #           #   #       #   #         #   F
#####################################################################################################
