###########
I   #   # #
### # # # #
#   # #   #
# ### #####
#   #     #
### ### # #
#   #   # #
# ### ### #
#     #   F
###########
